{
    "Paseo/21 --- Paseo/23": 1,
    "Paseo/23 --- Paseo/21": 1, 
    "Paseo/23 --- Paseo/25": 1, 
    "Paseo/25 --- Paseo/23": 1, 
    "Paseo/21 --- A/21": 1, 
    "A/21 --- B/21": 1, 
    "B/21 --- C/21": 1, 
    "C/21 --- D/21": 1, 
    "D/21 --- E/21": 1, 
    "E/21 --- F/21": 1, 
    "F/21 --- G/21": 1, 
    "Paseo/23 --- A/23": 1, 
    "A/23 --- Paseo/23": 1, 
    "A/23 --- B/23": 1, 
    "B/23 --- A/23": 1, 
    "B/23 --- C/23": 1, 
    "C/23 --- B/23": 1, 
    "C/23 --- D/23": 1, 
    "D/23 --- C/23": 1, 
    "D/23 --- E/23": 1, 
    "E/23 --- D/23": 1, 
    "E/23 --- F/23": 1, 
    "F/23 --- E/23": 1, 
    "F/23 --- G/23": 1, 
    "G/23 --- F/23": 1, 
    "G/25 --- F/25": 1, 
    "F/25 --- E/25": 1, 
    "E/25 --- D/25": 1, 
    "D/25 --- C/25": 1, 
    "C/25 --- B/25": 1, 
    "B/25 --- A/25": 1, 
    "A/25 --- Paseo/25": 1, 
    "G/25 --- G/23": 1, 
    "G/23 --- G/25": 1, 
    "G/23 --- G/21": 1, 
    "G/21 --- G/23": 1, 
    "G/21 --- G/19": 1, 
    "G/19 --- G/21": 1, 
    "G/19 --- E/19": 1, 
    "A/21 --- A/23": 1, 
    "A/23 --- A/25": 1, 
    "B/25 --- B/23": 1, 
    "B/23 --- B/21": 1, 
    "C/21 --- C/23": 1, 
    "C/23 --- C/25": 1, 
    "D/25 --- D/23": 1, 
    "D/23 --- D/21": 1, 
    "E/19 --- E/21": 1, 
    "E/21 --- E/23": 1, 
    "E/23 --- E/25": 1, 
    "F/25 --- F/23": 1, 
    "F/23 --- F/21": 1
}